####################
#..................#
#......P...........#
#..................#
#......####........#
#..................#
####################