####################
#..................#
#......P....E.......#
#..................#
#......####........#
#..................#
####################